1111111111111
10111000C0001
100C00C111001
1C00C01100IC1
1E00C0P101001
10111000C0001
100C00C111001
1C00C011000C1
1101C00101I01
10111000C0001
100C00C111001
1C00C011000C1
1100C00101I01
10111000C0001
100C00C111001
1C00C011000C1
1100C00101001
1111111111111