1111111
100C001
10P0001
1C0C001
1C0CE01
1111111