1111111
100P011
110C001
1C01C01
1010CE1
1111111