1111111
1000CI1
10P0001
1CC0CI1
10E0C01
1111111