1111111
1P00C01
1000001
1C00C01
1E00C01
1111111