1111111
100P001
100C001
1C00C01
1000CE1
1111111