1111111
1000C01
100C001
1C00C01
1E0PC01
1111111