1111111
1P00C01
10000I1
1C00C01
1EI0C01
1111111