1111111
111C001
10P0101
1C0C001
1C1CE01
1111111