1111111
1P00CI1
10000I1
1C00CI1
1E00CI1
1111111