1111111
1000C01
10P0001
1CC0C01
10E0C01
1111111